...###
.....#.####
.##.@###..#
##........#
#......#..#
###..###..#
..#..#....#
.##..#.#.##
.#........
.#.....#.
.##..#..